0000000000
0055555500
0044444400
0033333300
0022222200
0011111100
0000000000
0000000000
0000000000
0000000000
0000000000
0000000000