2020202020
1010101010
0202020202
0101010101
0000000000
0000000000
0000000000
0000000000