3232323232
2323232323
1111111111
1111111111
0000000000
0000000000
0000000000
0000000000