5555555555
1111111111
1111111111
1111111111
1111111111
0000000000
0000000000
0000000000