4004004004
0220220220
0220220220
0110110110
0000000000
0000000000
0000000000
0000000000